tile cave_wall 0
tile stone 1
tile cave_wall_front0 2
tile cave_wall_front1 3
tile cave_wall_front2 4
tile cave_wall_front3 5
size 2 20 15

1 1 1 1 1 1 1 1 1 1 1 1 1 1 1 1 1 1 1 1
1 1 1 1 1 1 1 1 1 1 1 1 1 1 1 1 1 1 1 1
1 1 1 1 1 1 1 1 1 1 1 1 1 1 1 1 1 1 1 1
1 1 1 1 1 1 1 1 1 1 1 1 1 1 1 1 1 1 1 1
1 1 1 1 1 1 1 1 1 1 1 1 1 1 1 1 1 1 1 1
1 1 1 1 1 1 1 1 1 1 1 1 1 1 1 1 1 1 1 1
1 1 1 1 1 1 1 1 1 1 1 1 1 1 1 1 1 1 1 1
1 1 1 1 1 1 1 1 1 1 1 1 1 1 1 1 1 1 1 1
1 1 1 1 1 1 1 1 1 1 1 1 1 1 1 1 1 1 1 1
1 1 1 1 1 1 1 1 1 1 1 1 1 1 1 1 1 1 1 1
1 1 1 1 1 1 1 1 1 1 1 1 1 1 1 1 1 1 1 1
1 1 1 1 1 1 1 1 1 1 1 1 1 1 1 1 1 1 1 1
1 1 1 1 1 1 1 1 1 1 1 1 1 1 1 1 1 1 1 1
1 1 1 1 1 1 1 1 1 1 1 1 1 1 1 1 1 1 1 1
1 1 1 1 1 1 1 1 1 1 1 1 1 1 1 1 1 1 1 1

 0  0  0  0  0  0  0  0 -1  0  0  0  0  0  0  0  0  0  0  0
 0  0  0  0  0  0  0  0 -1  0  0  0  0  0  0  0  0  0  0  0
 0  0  0  0  0  3  3  4 -1  0  0  0  0  0  0  0  0  0  0  0
 0  0  0  0  0 -1 -1 -1 -1  0  0  0  0  0  0  0  0  0  0  0
 0  0  0  0  0 -1 -1 -1 -1  0  0  0  0  0  0  0  0  0  0  0
 0  0  0  0  0  0  0  0 -1  0  0  0  0  0  0  0  0  0  0  0
 0  0  0  0  0  0  0  0 -1  0  0  0  0  0  0  0  0  0  0  0
 0  0  0  0  0  0  0  0 -1  0  0  0  0  0  0  0  0  0  0  0
 0  0  0  0  0  3  3  4 -1  2  3  3  0  0  0  0  0  0  0  0
 0  0  0  0  0 -1 -1 -1 -1 -1 -1 -1  0  0  0  0  0  0  0  0
 0  0  0  0  0 -1 -1 -1 -1 -1 -1 -1  2  3  3  0  0  0  0  0
 0  0  0  0  0  0 -1 -1 -1 -1 -1 -1 -1 -1 -1  0  0  0  0  0
 0  0  0  0  0  0  0  0  0 -1  0  0  0  0  0  0  0  0  0  0
 0  0  0  0  0  0  0  0  0  0  0  0  0  0  0  0  0  0  0  0
 0  0  0  0  0  0  0  0  0  0  0  0  0  0  0  0  0  0  0  0

player 9 12
box 8 5
box 8 6
box 8 7
box 8 8
portal 8 0
thorn 8 9